1 1 1 1 1 2 1 1 4 1 1 1 1 1 1 3 1 1 1 1 1 1 1 1
1 0 0 0 0 0 0 0 0 0 0 0 0 0 0 0 0 0 0 0 0 0 0 1
1 0 0 0 0 0 0 0 0 0 0 0 0 0 0 0 0 0 0 0 0 0 0 1
1 0 0 0 0 0 0 0 0 0 0 0 0 0 0 0 0 0 0 0 0 0 0 1
4 0 0 0 0 0 1 2 1 2 2 0 0 0 0 5 0 5 0 5 0 0 0 3
1 0 0 0 0 0 1 0 0 0 1 0 0 0 0 0 0 0 0 0 0 0 0 1
1 0 0 0 0 0 2 0 0 0 2 0 0 0 0 5 0 0 0 5 0 0 0 1
1 0 0 0 0 0 1 0 0 0 1 0 0 0 0 0 0 0 0 0 0 0 0 1
3 0 0 0 0 0 2 2 0 1 2 0 0 0 0 5 0 5 0 5 0 0 0 1
1 0 0 0 0 0 0 0 0 0 0 0 0 0 0 0 0 0 0 0 0 0 0 1
1 0 0 0 0 0 0 0 0 0 0 0 0 0 0 0 0 0 0 0 0 0 0 2
1 0 0 0 0 0 0 0 0 0 0 0 0 0 0 0 0 0 0 0 0 0 0 1
1 0 0 0 0 0 0 0 0 0 0 0 0 0 0 0 0 0 0 0 0 0 0 4
1 0 0 0 0 0 0 0 0 0 0 0 0 0 0 0 0 0 0 0 0 0 0 1
2 0 0 0 0 0 0 0 0 0 0 0 0 0 0 0 0 0 0 0 0 0 0 1
1 0 0 0 0 0 0 0 0 0 0 0 0 0 0 0 0 0 0 0 0 0 0 1
4 7 7 7 7 7 7 7 7 0 0 0 0 0 0 0 0 0 0 0 0 0 0 3
1 7 0 2 0 0 0 0 7 0 0 0 0 0 0 0 0 0 0 0 0 0 0 1
1 7 0 0 0 0 8 0 7 0 0 0 0 0 0 0 0 0 0 0 0 0 0 1
1 7 0 2 0 0 0 0 7 0 0 0 0 0 0 0 0 0 0 0 0 0 0 1
3 7 0 7 7 7 7 7 7 0 0 0 0 0 0 0 0 0 0 0 0 0 0 1
1 7 0 0 0 0 0 0 0 0 0 0 0 0 0 0 0 0 0 0 0 0 0 1
1 7 7 7 7 7 7 7 7 0 0 0 0 0 0 0 0 0 0 0 0 0 0 1
1 1 3 1 1 1 4 1 2 1 1 1 1 1 3 1 1 1 4 1 2 1 1 1